EuroS&P 2023    
 Home 
  Program | Full 
  Compact 
  Accepted Papers & Awards 
  Call For... | Papers 
  Posters 
  Workshop Proposals 
  Workshops 
  Mentoring 
  Organization | Steering Committee 
  Program Committee 
  Organizing Committee 
  Attending | Venue 
  Registration 
  Remote Presentation Guide 
  Attendee Code of Conduct 
  Past Editions | EuroS&P 2022 
  EuroS&P 2021 
  EuroS&P 2020 
  EuroS&P 2019 
  EuroS&P 2018 
  EuroS&P 2017 
  EuroS&P 2016 
  Twitter 
  Facebook 
  Youtube 

 Delft, July 3-7, 2023  
 8th IEEE European Symposium on Security and Privacy  
   
 Since 1980, the IEEE Symposium on Security and Privacy has been the premier forum for presenting developments in computer security and electronic privacy, and for bringing together researchers and practitioners in the field. Following this story of success, IEEE initiated the European  Symposium on Security and Privacy (EuroS&P), which is organized every year in a European city.  
 The 8th EuroS&P edition will be held on July 3-7, 2023 at TU Delft ECHO  and is organized by TU Delft Cybersecurity group  .  

  Last Updates  

  Best Paper Award:  Forward Pass: On the Security Implications of Email Forwarding Mechanism and Policy  
  
 Authors:  Enze Liu  (University of California, San Diego), Gautam Akiwate  (Stanford University), Mattijs Jonker  (University of Twente), Ariana Mirian  (University of California, San Diego), Grant Ho  (University of California, San Diego), Geoffrey M. Voelker  (University of California, San Diego), Stefan Savage  (University of California, San Diego)  

  Digital proceedings now available online:   

 EuroS&P proceedings 
  EuroS&P Workshops proceedings 
  Euro S&P Poster session proceedings 

  We created a form for PC nominations for Euro S&P: link here  .  
  Important Dates  
 All deadlines are Anywhere on Earth (AoE = UTC-12h)   .  
  
 Research Papers | Submission deadlines> | 26 October 2022 (Wednesday) 
 Author's Response Period | 18 - 25 January 2023  s> 
 Author Notification | 12 February 2023 (Sunday) 
 Submission of revised papers | 14 March 2023 (Tuesday) 
 Camera ready deadline | 3 April 2023 (Wednesday) 
 Workshop Papers | Submission deadline | see individual workshop pages 
 EuroS&P 2023 | Workshops | 3 and 7 July 2023 
 Main Conference | 4 - 6 July 2023 
  
  Organizing Committee  
  
 Program Chairs and Members | David Evans | University of Virginia, USA 
 Herbert Bos | VU Amsterdam, The Netherlands 
 General Chairs | Kaitai Liang | TU Delft, The Netherlands 
 Georgios Smaragdakis | TU Delft, The Netherlands 
 Workshop Chairs | Fabio Pierazzi | KCL, UK 
 Giovanni Apruzzese | University of Liechtenstein, Liechtenstein 
 Publication Chairs | Luca Verderame | Univesità di Genova, Italy 
 Stefanie Roos | TU Delft, The Netherlands 
 Publicity Chair | Savvas Zannettou | TU Delft, The Netherlands 
 Poster Chair | Luca Mariot | University of Twente, The Netherlands 
 Financial Chair | Stjepan Picek | Radboud University and TU Delft, The Netherlands 
 Web Chair | Roland Kromes | TU Delft, The Netherlands 
 Mentoring Chair | Vera Rimmer | KU Leuven, Belgium 
 Azqa Nadeem | TU Delft, The Netherlands 
 Sponsorship Chair | Giovane Moura | SIDN/TU Delft, The Netherlands 
  
  Program Committee  
  
 Ghada Almashaqbeh | University of Connecticut, United States of America 
 Giovanni Apruzzese | University of Liechtenstein, Liechtenstein 
 Musard Balliu | KTH Royal Institute of Technology, Sweden 
 Abhishek Bichhawat | IIT Gandhinagar, India 
 Ioana Boureanu | University of Surrey, United Kingdom 
 Samira Briongos | NEC Laboratories Europe, Spain 
 Stefan Brunthaler | μCSRL, CODE Research Institute, Bundeswehr University Munich, Germany 
 Jianjun Chen | Tsinghua University, China 
 Tom Chothia | University of Birmingham, United Kingdom 
 Mauro Conti | University of Padua, Italy 
 Andrea Continella | University of Twente, Netherlands 
 Lucas Davi | University of Duisburg-Essen, Germany 
 Tariq Elahi | University of Edinburgh, United Kingdom 
 Birhanu Eshete | University of Michigan-Dearborn, United States of America 
 Aurore Fass | Stanford University, United States of America 
 Carlos Ganan | ICANN, Netherlands 
 Simson Garfinkel | Schmidt Futures, United States of America 
 Esha Ghosh | Microsoft Research, Redmond, United States of America 
 Berk Gulmezoglu | Iowa State University, United States of America 
 Wahij Ul Hassan | University of Virginia, United States of America 
 Xiali (Sharon) Hei | University of Louisiana, United States of America 
 Julia Hesse | IBM Research Europe - Zurich, Switzerland 
 Charlie Jacomme | Inria Paris, France 
 Doowon Kim | University of Tennessee, United States of America 
 Evgenios M. Kornaropoulos | George Mason University, United States of America 
 Catherine Meadows | US Naval Research Laboratory, United States of America 
 Veelasha Moonsamy | Ruhr University Bochum, Germany 
 Jan Tobias Muehlberg | KU Leuven, Belgium 
 Nick Nikiforakis | Stony Brook University, United States of America 
 Cristina Nita-Rotaru | Northeastern University, United States of America 
 Paolo Palmieri | University College Cork, Ireland 
 Thomas Pasquier | University of British Columbia, Canada 
 Giancarlo Pellegrino | CISPA Helmhotz Center for Information Security, Germany 
 Erwin Quiring | Ruhr University Bochum, Germany 
 Neetesh Saxena | Cardiff University, United Kingdom 
 Mridula Singh | CISPA Helmholtz Center for Information Security, Germany 
 Asia Slowinska | Ioli Labs 
 Guillermo Suarez-Tangil | IMDEA Networks Institute, Spain 
 Yuzhe Tang | Syracuse University, United States of America 
 Di Wang | King Abdullah University of Science and Technology, Saudi Arabia 
 Jason (Minhui) Xue | CSIRO-Data61, Australia 
 Haibin Zhang | Beijing Institute of Technology, China 
 Ning Zhang | Washington University in St. Louis, United States of America 
 Xiao Zhang | CISPA Helmholtz Center for Information Security, Germany 
 Zhenkai Zhang | Clemson University, United States of America 
 Ziqiao Zhou | Microsoft Research, United States of America 
 Yanjun Zhang | Deakin University, Australia 
  
 Organization  
     
  Sponsors